###################
##	MAP N°0      ##
###################
# O = Obstacles
# field = magma
# boss map = yes
OOOOOOOOOOOOOOOO
OOOOOOOOOOOOOOOO
OOOOOOOOOOOOOOOO
O  OOOOOOOOO   O
O    O     O   O
O    O         O
O   O OOOOO    O
O   OOOOOOOOO  O
OOOOOOO        O
O     OOOOOOOOOO
O     O        O
OOOOOOOOOOOOOOOO