###################
##	MAP N°1      ##
###################
# O = Obstacles
# field = magma
# boss map = yes
OOOOOOOOOOOOOOOO
O              O
O          O   O
O  OOOOOOOOO   O
O    O     O   O
O    O         O
O   O OOOOO    O
O   O     OOO  O
OO  OOO        O
OO    O        O
OOO   O        O
OOOOOOOOOOOOOOOO