###################
##	MAP N°1      ##
###################
OOOOOOOOOOOOOOOOOO
OOOOOOOODOOOOOOOOO
OO              OO
OO              OO
OO              OO
OO              OO
OD              OO
OO              OO
OO              OO
OO              DO
OO              OO
OO              OO
OOOOOOOOOOOODOOOOO
OOOOOOOOOOOOOOOOOO
