###################
##	MAP N°4      ##
###################
OOOOOOOOOOOOOOOOOO
OOOOOOOOOOOOODOOOO
OO              OO
OO              OO
OO              OO
OO              OO
OO              OO
OD              OO
OO              OO
OO              DO
OO              OO
OO              OO
OOOOOOOODOOOOOOOOO
OOOOOOOOOOOOOOOOOO
