##################
##    MAP N°13  ##
##################
# O = obstacle
# D = door
# E = exit
# F = tile
# T = fire trap
# S = spike trap
# B = bear trap
# P = pit trap
# R, L, A, Z = right left top bottom push trap
# V = vitality
# 1 = cobra
# 3 = bat
OOOOOOOOOOOOOOOOOO
OOOOODOOOOOOOOOOOO
OOOFOFFTOFOFOFFFDO
OOFFOOOTOFFFOOFOOO
OOOFFFFFTFOFFOFOOO
ODFFOOFOFOOOFFFFOO
OOOOOOOOOOFOOOOFOO
OOFFFFOFO3FFFFFFOO
OOFOOFFFOOOOOFOOOO
OOFOFFOFFFFOFFFFOO
OOFOOFOOOOFFFOFOOO
OO1OFFOFFFFOFOF1OO
OOOODOOOOOOOOOOOOO
OOOOOOOOOOOOOOOOOO
