##################
##	  MAP N°16  ##
##################
OOOOOOOOOOOOOOOOOO
OOOOOOOODOOOOOOOOO
OOFFFFFFFFFFFFFFOO
OOFF1FFFFFFF1FFFOO
OOFFFFFOOOOFFFFFOO
OOFFFFFO11OFFFFFOO
ODFFFFFO11OFFFFFDO
OOFFFFFOOOOFFFFFOO
OOFFFFFFFFFFFFFFOO
OOFF1FFFFFFF1FFFOO
OOFFFFFFFFFFFFFFOO
OOFFFFFFFFFFFFFFOO
OOOOOOOODOOOOOOOOO
OOOOOOOOOOOOOOOOOO