##################
##	MAP N°11    ##
##################
# O = obstacle
# D = door
# E = exit
# F = tile
# T = fire trap
# S = spike trap
# B = bear trap
# P = pit trap
# R, L, A, Z = right left top bottom push trap
# 1 = cobra
OOOOOOOOOOOOOOOOOO
OOOOOOOODOOOOOOOOO
OOTOOOOOFOOOOOTTOO
OOTO1FFFFFFF1OTTOO
OOTOFFFFFFFFFOTTOO
OOOOFFFFFFFFFOOOOO
ODFFFFFFFFFFFFFFDO
OOOOOFFFFFFFFOOOOO
OOTTOFFFFFFFFOTTOO
OOTTOFFFFFFFFOTTOO
OOTTO1FFFFFF1OTTOO
OOTTOOOOFOOOOOTTOO
OOOOOOOODOOOOOOOOO
OOOOOOOOOOOOOOOOOO