##################
##    MAP N°11  ##
##################
OOOOOOOOOOOOOOOOOO
OOOODOOOOOOOOOOOOO
OOFOFOFOFOFFFOFOOO
OOFFFFFFSFSOFFFFOO
OOFOOOOOFOFOOFOFOO
OOOOFOFFSOOOFFOFOO
ODFFFFFOFFFOOFOFOO
OOOOOFOOFOOOFFOFOO
OOFFFFFOFFFOOFOFOO
OOOOOOFOFOOOOFOFOO
OOOOOOOOSFFFOFOFOO
OOFFFFFFFOFOO3OFDO
OODOOOOOOOOOOOOOOO
OOOOOOOOOOOOOOOOOO
