##################
##    MAP N°17  ##
##################
# O = obstacle
# D = door
# E = exit
# F = tile
# T = fire trap
# S = spike trap
# B = bear trap
# P = pit trap
# R, L, A, Z = right left top bottom push trap
# V = vitality
# 1 = cobra
# 3 = bat
OOOOOOOOOOOOOOOOOO
OOOOOOODOOOOOOOOOO
OOVTTTOFFFOFOFOFOO
OOOOOFOOOFOFOFFFOO
OOFFFFOFOFOFOFOOOO
OOOFOFFFFFFFFFOOOO
OOOOOOFOFOOFOFFFDO
ODFFFFFOFOFFOOOFOO
OOOOOOFOFOOFFFOFOO
OOFFFFFOF3OOFOOFOO
OOOFOFOOFOOFFFOFOO
OO1FOFOOFOOFOFO1OO
OOOOOOOOOOOOODOOOO
OOOOOOOOOOOOOOOOOO
