##################
##    MAP N°1   ##
##################
OOOOOOOOOOOOOOOOOO
OOOOOOOODOOOOOOOOO
OOOOOFFFFFFOOOOVOO
OOOOFFFTFFFFOOF1OO
OOOFFFFTFFFFFOFFOO
OOFFFFFTFFFFFOFFOO
ODFTTTTTFTTTTTTFDO
OOFFFFFFFTFFFFFFOO
OOOBFFFFFTFFFFFFOO
OOOFFFFFFTFFFFFOOO
OOOOFFFFFTFFFOOOOO
OOOOOOFFFFFFOOOOOO
OOOOOOOODOOOOOOOOO
OOOOOOOOOOOOOOOOOO
