##################
##    MAP N°16  ##
##################
# O = obstacle
# D = door
# E = exit
# F = tile
# T = fire trap
# S = spike trap
# B = bear trap
# P = pit trap
# R, L, A, Z = right left top bottom push trap
# V = vitality
# 1 = cobra
# 3 = bat
OOOOOOOOOOOOOOOOOO
OOOOOOOOODOOOOOOOO
OO1OFOFFOFOFOFF1OO
OOFOFOOFOFOFOFOFOO
OOFOFOFFFFFFFFOFOO
OOFSSFFOSOFOFOOFOO
OOOOFOOOSOFOSOOFDO
ODFFFOFFFOFOFOOOOO
OOOOFOOOFOOOSFFFOO
OOFFFOOFFOOFFOFOOO
OOFOFOOOFOFFOOFFOO
OO1O1OFFFOFOO1FOOO
OOOOOODOOOOOOOOOOO
OOOOOOOOOOOOOOOOOO
