##################
##    MAP N°12  ##
##################
# O = obstacle
# D = door
# E = exit
# F = tile
# T = fire trap
# S = spike trap
# B = bear trap
# P = pit trap
# R, L, A, Z = right left top bottom push trap
# V = vitality
# 1 = cobra
# 3 = bat
OOOOOOOOOOOOOOOOOO
OOOOOOOODOOOOOOOOO
OOOFFFOOFOOFFFF3OO
OOFFOFFOFOFFOOOOOO
OOOOOOFSSOOFFFFOOO
OOFFFFFOFFFFOOFFOO
ODFOOOOOOFOFFOFOOO
OOOOOFOFOFOOOOFFOO
OOOOFSFFFSOOOOOOOO
OOFFFOFOOFFFFFFFDO
OOOOFOFOOFOOFOOFOO
OO3FFOFOFFFOFFOFOO
OOOOOODOOOOOOOOOOO
OOOOOOOOOOOOOOOOOO
