##################
##	MAP N°13    ##
##################
# O = obstacle
# D = door
# E = exit
# F = tile
# T = fire trap
# S = spike trap
# B = bear trap
# P = pit trap
# R, L, A, Z = right left top bottom push trap
# 1 = cobra
OOOOOOOOOOOOOOOOOO
OOOOOOOODOOOOOOOOO
OO1FFFFFFFFFFFFFOO
OOFOOOOOOOOOOOOFOO
OOFOTTTTTTTTTTOFOO
OOFOTTTTTTTTTTOFOO
ODFOTTTTTTTTTTOFDO
OOFOTTTTTTTTTTOFOO
OOFOTTTTTTTTTTOFOO
OOOOTTTTTTTTTTOFOO
OOFOOOOOOOOOOOOFOO
OOFFFFFFFFFFFFFFOO
OOOOOOOODOOOOOOOOO
OOOOOOOOOOOOOOOOOO
