##################
##    MAP N°1   ##
##################
OOOOOOOOOOOOOOOOOO
OOOOOOOOOODOOOOOOO
OOFFFFFOFOFOOVOFDO
OOOFOOFTFOFOOTOFOO
OOOFOFFOFFTOOTOFOO
ODFFOOFOOOFOOFFFOO
OOOFFOOOFFTFFFOOOO
OOFFOOFFFOOFOFFFOO
OOOF3OOOFOFFOFOOOO
OOOOOOOFFOOFOFFFOO
OOVOFOFFOOFFOFOFOO
OOTTFFFOOFFOOFOFOO
OODOOOOOOOOOOOOOOO
OOOOOOOOOOOOOOOOOO
