##################
##	  MAP N°18   ##
##################
OOOOOOOOOOOOOOOOOO
OOOOOOOODOOOOOOOOO
OO1FFFFFFFFFFFF1OO
OOFFFFFOOOFFFFFFOO
OOFTFTFTTFTFFTFFOO
OOFTFTFTFFTFFTFFOO
ODFTTTFTTFTFFTFFDO
OOFTFTFTFFTFFTFFOO
OOFTFTFTTFTTFTTFOO
OOFFFFFFFFFFFFFFOO
OOFFFFFOOOFFFFFFOO
OO1FFFFFFFFFFFF1OO
OOOOOOOODOOOOOOOOO
OOOOOOOOOOOOOOOOOO