##################
##	MAP N°10    ##
##################
# O = obstacle
# D = door
# E = exit
# F = tile
# T = fire trap
# S = spike trap
# B = bear trap
# P = pit trap
# R, L, A, Z = right left top bottom push trap
# 1 = cobra
OOOOOOOOOOOOOOOOOO
OOOOOOOODOOOOOOOOO
OOTTTTTOFOTTTTTTOO
OOTT1TTOFOTTT1TTOO
OOTTTTTOFOTTTTTTOO
OOOOOOOOFOOOOOOOOO
ODFFFFFF1FFFFFFFDO
OOOOOOOOFOOOOOOOOO
OOTTTTTOFOTTTTTTOO
OOTTTTTOFOTTTTTTOO
OOTT1TTOFOTTT1TTOO
OOTTTTTOFOTTTTTTOO
OOOOOOOODOOOOOOOOO
OOOOOOOOOOOOOOOOOO