##################
##    MAP N°18  ##
##################
# O = obstacle
# D = door
# E = exit
# F = tile
# T = fire trap
# S = spike trap
# B = bear trap
# P = pit trap
# R, L, A, Z = right left top bottom push trap
# V = vitality
# 1 = cobra
# 3 = bat
OOOOOOOOOOOOOOOOOO
OOOOOOODOOOOOOOOOO
OOOFOFOFOFFFFOO3OO
OOFFOFOFFFOOFFOFOO
OOOFFFOOOOOOOFFFOO
OOOOOFOOOOFOFFOFOO
ODFFFFFFFFFOOOOFDO
OOOOOFOOOOFFOOFFOO
OOOOOOOOFOOFOFFOOO
OOFFFFFFFFFFFFOOOO
OOOOOOOOOFOFOFOFOO
OO3FFFFFFFOFOFFFOO
OOOOOOOOODOOOOOOOO
OOOOOOOOOOOOOOOOOO
