###################
##	MAP N°1      ##
###################
# O = obstacle
# D = door
# E = exit
# F = tile
# T = fire trap
OOOOOOOOOOOOOOOOOO
OOOOOOOODOOOOOOOOO
OOFAFFFFFFFFFFFFOO
OOFOFFSFTFFFFFFFOO
OOFFFFFFFFFFFFFFOO
OOFFFFFFFFFFFFFFOO
ODFTFFBFFFPFFFFFOO
OOFFFFFFFFFFFFFFOO
OOLOFFFFFFFFFFOROO
OOFFFFFFFFFFFFTFDO
OOFFFFFFOFFFTFFFOO
OOFFFFFFZFFFFFFFOO
OOOOOOOOOOOODOOOOO
OOOOOOOOOOOOOOOOOO
