##################
##	  MAP N°17  ##
##################
OOOOOOOOOOOOOOOOOO
OOOOOOOODOOOOOOOOO
OOOOFFFSFFFFFFFFOO
OOOOOFFSBOOOOORFOO
OOTOFFFFFFFFFFFFOO
OOPPPPPFFFFFPPPPOO
ODFFFFFFPPPFFFFFDO
OOPPPPPFFFFFPPPPOO
OOFFFFFFFFFFFFBFOO
OOFFFFFFFFSSSFFFOO
OOFFFFFOOOOFFFFFOO
OO1FFFFFFFFFPFFFOO
OOOOOOOODOOOOOOOOO
OOOOOOOOOOOOOOOOOO