###################
##	MAP N°1      ##
###################
# O = obstacle
# D = door
# E = exit
# F = tile
# T = fire trap
OOOOOOOOOOOOOOOOOO
OOOOOOOODOOOOOOOOO
OOFFFFFFFFFFFFFFOO
OOFFFFFFTFFFFFFFOO
OOFFFFFFFFFFFFFFOO
OOFFFFFFFFFFFFFFOO
ODFTFFFFFFFFFFFFOO
OOFFFFFFFFFFFFFFOO
OOFFFFFFFFFFFFFFOO
OOFFFFFFFFFFFFTFDO
OOFFFFFFFFFFTFFFOO
OOFFFFFFFFFFFFFFOO
OOOOOOOOOOOODOOOOO
OOOOOOOOOOOOOOOOOO
