##################
##    MAP N°14  ##
##################
# O = obstacle
# D = door
# E = exit
# F = tile
# T = fire trap
# S = spike trap
# B = bear trap
# P = pit trap
# R, L, A, Z = right left top bottom push trap
# V = vitality
# 1 = cobra
# 3 = bat
OOOOOOOOOOOOOOOOOO
OOOOOOODOOOOOOOOOO
OO1FFFFFFFFSFFFSOO
OOOOOOOOOOOOOFOFOO
OOO3OOFOOOOFOOOFOO
OOFFFFFFFFFFFFFSOO
OOOOOOOOOOOOOOOFOO
OOFFFFFSFFFFFFFFOO
OOOOOOOFOFOOOFOFOO
ODFFFOOFOFOOFFOFDO
OOOOSFFFOFOFFOOFOO
OOFFFOOFOFOOFOO1OO
OODOOOOOOOOOOOOOOO
OOOOOOOOOOOOOOOOOO
