##################
##	MAP N°15    ##
##################
# O = obstacle
# D = door
# E = exit
# F = tile
# T = fire trap
# S = spike trap
# B = bear trap
# P = pit trap
# R, L, A, Z = right left top bottom push trap
# 1 = cobra
OOOOOOOOOOOOOOOOOO
OOOOOOOOOOOOODOOOO
OOFFFFFFFFF1OFFFOO
OOFOOAFFFFFOOORFDO
OOFLOOAFFFFFOFFFOO
OOFFLOOAFFFFFFFFOO
OOFFFLOOAFFFFFFFOO
OOFFFFLOORFFFFFFOO
ODFBFFFZOOORFFFFOO
OOBFOOOFFZOOORFFOO
OOFFFFZFFFFZOOOFOO
OOFFFFFFFFFFFFFFOO
OOOOOODOOOOOOOOOOO
OOOOOOOOOOOOOOOOOO