##################
##    MAP N°10  ##
##################
# O = obstacle
# D = door
# E = exit
# F = tile
# T = fire trap
# S = spike trap
# B = bear trap
# P = pit trap
# R, L, A, Z = right left top bottom push trap
# V = vitality
OOOOOOOOOOOOOOOOOO
OOOOOOOODOOOOOOOOO
OOTTTTTOFOTTTTTTOO
OOTTTTTOFOTTTTTTOO
OOTTTTTOFOTTTTTTOO
OOOOOOOOFOOOOOOOOO
ODFFFFFFFFFFFFFFDO
OOOOOOOOFOOOOOOOOO
OOTTTTTOFOTTTTTTOO
OOTTTTTOFOTTTTTTOO
OOTTTTTOFOTTTTTTOO
OOTTTTTOFOTTTTTTOO
OOOOOOOODOOOOOOOOO
OOOOOOOOOOOOOOOOOO
