##################
##	MAP N°12    ##
##################
# O = obstacle
# D = door
# E = exit
# F = tile
# T = fire trap
# S = spike trap
# B = bear trap
# P = pit trap
# R, L, A, Z = right left top bottom push trap
# 1 = cobra
OOOOOOOOOOOOOOOOOO
OOOOOOOODOOOOOOOOO
OOTOOOOOFOOOOOTTOO
OOTO1FFFFFFF1OTTOO
OOTOSFSFSFSFSOTTOO
OOOOFFFFFFFFFOOOOO
ODFFFSFSFSFSFFFFDO
OOOOOFFFFFFFFOOOOO
OOTTOFFFFFFFFOTTOO
OOTTOFSFSFSFFOTTOO
OOTTO1FFFFFF1OTTOO
OOTTOOOOFOOOOOTTOO
OOOOOOOODOOOOOOOOO
OOOOOOOOOOOOOOOOOO