##################
##	MAP N°14    ##
##################
# O = obstacle
# D = door
# E = exit
# F = tile
# T = fire trap
# S = spike trap
# B = bear trap
# P = pit trap
# R, L, A, Z = right left top bottom push trap
# 1 = cobra
OOOOOOOOOOOOOOOOOO
OOOOOOOODOOOOOOOOO
OOTOOOOOFOOOOOOTOO
OOTO1FFFFFFF1OTOOO
OOTOFFFFOFFFFOTOOO
OOOOFFF1OFFFFOOOOO
ODFFFOOOOOOOFFFFDO
OOOOOFFFO1FFFOOOOO
OOOTOFFFOFFFFOTOOO
OOOTOFFFOFFFFOTOOO
OOOTO1FFFFFFFOTOOO
OOTOOOOOFOOOOOOTOO
OOOOOOOODOOOOOOOOO
OOOOOOOOOOOOOOOOOO