##################
##    MAP N°2   ##
##################
OOOOOOOOOOOOOOOOOO
OOOOOOOODOOOOOOOOO
OO1FFFFFFFFFFFF1OO
OOFFFFFFFFFFFFFFOO
OOFFFFFFFFFFFFFFOO
OOFOOOFFSSSOOOFFOO
ODFOOFSFFFSOOOFFDO
OOFFFFSSSFSOOOOOOO
OOOOOOSSSFSOOOOOOO
OOOOOOSFFFSOOOOOOO
OOOOOOSFSSSOOOOOOO
OOOOOOSFFSSOOOOOOO
OOOOOOOODOOOOOOOOO
OOOOOOOOOOOOOOOOOO
