###################
##	MAP N°2      ##
###################
# O = obstacle
# D = door
# E = exit
# F = tile
# T = fire trap
OOOOOOOOOOOOOOOOOO
OOOOOOOOOOOOODOOOO
OOFFFFFFFFFFFFFFOO
OOFFFFFFFFFFFFFFDO
OOFFFFFFFFFFFFFFOO
OOFFFFFFFFFFFFFFOO
OOFFFFFFFFFFFFFFOO
OOFFFPFFFFFFFFFFOO
ODFFFFFFTFFFFFFFOO
OOFFFFFFFBFFFFFFOO
OOFFFFFFFFFSFFFFOO
OOFFFFFFFFFFFFFFOO
OOOOOODOOOOOOOOOOO
OOOOOOOOOOOOOOOOOO
