##################
##    MAP N°20  ##
##################
# O = obstacle
# D = door
# E = exit
# F = tile
# T = fire trap
# S = spike trap
# B = bear trap
# P = pit trap
# R, L, A, Z = right left top bottom push trap
# V = vitality
# 1 = cobra
# 3 = bat
OOOOOOOOOOOOOOOOOO
OOOOOOOODOOOOOOOOO
OO1FPFOOFOFFFFF3OO
OOOFPFBFFFFOFBFFOO
OOFFPFFFOFOOOOOFOO
OOOFPPFOOOOOOFFFDO
OOFFFPPPFBFOFFBFOO
ODFOFFOFFFFPPPPFOO
OOOOOFFFPPFFFFFFOO
OOFFFFBFPPPFOFOFOO
OOPPPPPPPFPFOFOFOO
OO3FFFFFFFFFOFO3OO
OOOOOOODOOOOOOOOOO
OOOOOOOOOOOOOOOOOO
