##################
##    MAP N°28  ##
##################
# O = obstacle
# D = door
# E = exit
# F = tile
# T = fire trap
# S = spike trap
# B = bear trap
# P = pit trap
# R, L, A, Z = right left top bottom push trap
# V = vitality
# 1 = cobra
# 3 = bat
OOOOOOOOOOOOOOOOOO
OOOOOOOODOOOOOOOOO
OOTOOOOOFOOOOOOTOO
OOOOOOOOFFOOOOOOOO
OOOOOOOOOFOOOOOOOO
OOOOOOOFFFOOOOOOOO
ODFFFFFFOOOOOOOFDO
OOOOOOOFFFOOOOFFOO
OOOOOOOFOFFFFFFOOO
OOOOOOOFOOOOOOOOOO
OOOOOOOFFOOOOOOOOO
OOTOOOOOFOOOOOOTOO
OOOOOOOODOOOOOOOOO
OOOOOOOOOOOOOOOOOO