##################
##    MAP N°25  ##
##################
# O = obstacle
# D = door
# E = exit
# F = tile
# T = fire trap
# S = spike trap
# B = bear trap
# P = pit trap
# R, L, A, Z = right left top bottom push trap
# V = vitality
# 1 = cobra
# 3 = bat
OOOOOOOOOOOOOOOOOO
OOOOOOOODOOOOOOOOO
OO1FOFOOFOFFFFF3OO
OOOFOFOFFOFOOOFOOO
OO3FFFFFOORLOOOOOO
OOOOFOOOOOROO1OFDO
ODFFFFOOLOROFFFFOO
OOO3OSFSFSFSFOFOOO
OOOOOLOOOOOFOOOOOO
OOFOFFFFFOOOOFOFOO
OOFOFOOOOOFFFFFFOO
OOFFFFFFFFFOFOFOOO
OOOOOOODOOOOOOOOOO
OOOOOOOOOOOOOOOOOO