##################
##    MAP N°23  ##
##################
# O = obstacle
# D = door
# E = exit
# F = tile
# T = fire trap
# S = spike trap
# B = bear trap
# P = pit trap
# R, L, A, Z = right left top bottom push trap
# V = vitality
# 1 = cobra
# 3 = bat
OOOOOOOOOOOOOOOOOO
OOOOOOOOOOOOOODOOO
OO1O3OFOFOFOOOFOOO
OOFOFOFOFFFFOFFFOO
OOFOOOFOOOOFFFOFOO
OOFFFFFFFFOOOOOFOO
ODFOOOOFOFFFFFFFOO
OOOOFFFFOOOFOFOFOO
OOFFFOOFOOFFOFOFOO
OO1OFOFFOFFOOFOFOO
OOOOOOOFOFOOFFOFOO
OO1FFFFFOFOFFOOFDO
OOOOOOOOODOOOOOOOO
OOOOOOOOOOOOOOOOOO