##################
##    MAP N°3   ##
##################
OOOOOOOOOOOOOOOOOO
OOOOOOOODOOOOOOOOO
OOTTFFFFFFFFFFTTOO
OOTTFOOOOOOOOFTTOO
OOFFFOFFFFF1OFFFOO
OOFFFOFFOOO1OFFFOO
ODFFFFFFOV11OFFFDO
OOFFFOFFOOO1OFFFOO
OOFFFOFFFFF1OFFFOO
OOFFFOOOOOOOOFFFOO
OOTTFFFFFFFFFFTTOO
OOTTFFFFFFFFFFTTOO
OOOOOOOODOOOOOOOOO
OOOOOOOOOOOOOOOOOO
