###################
##	MAP N°3      ##
###################
OOOOOOOOOOOOOOOOOO
OODOOOOOOOOOOOOOOO
OO              OO
OO              OO
OO              OO
OO              OO
OO              OO
OO              OO
OO              OO
OO              OO
OO              DO
OD              OO
OOODOOOOOOOOOOOOOO
OOOOOOOOOOOOOOOOOO
