###################
##	MAP N°3      ##
###################
OOOOOOOOOOOOOOOOOO
OOOOOOOOODOOOOOOOO
OOFFFFFFFFFFFFFFOO
OOFFFFFFFFFFFFFFOO
OOFFFFFFFFFFFFFFOO
OOFFFFFFFFFFFFFFOO
ODFFFFFFFFFFFFFFOO
OOFFFFFFFFFFFFFFOO
OOFFFFFFFFFFFFFFOO
OOFFFFFFFFFFFFFFOO
OOFFFFFFFFFFFFFFDO
OOFFFFFFFFFFFFFFOO
OOODOOOOOOOOOOOOOO
OOOOOOOOOOOOOOOOOO
