##################
##    MAP N°30  ##
##################
# O = obstacle
# D = door
# E = exit
# F = tile
# T = fire trap
# S = spike trap
# B = bear trap
# P = pit trap
# R, L, A, Z = right left top bottom push trap
# V = vitality
# 1 = cobra
# 3 = bat
OOOOOOOOOOOOOOOOOO
OOOOOOOODOOOOOOOOO
OOF3OOFOFFOFFFFFOO
OOFOOFFOOFOFOOOOOO
OOFFOOFFOFOFOO3OOO
OOOFFOOFFFFFOFFFOO
OOOOFFOOFOOOOFOOOO
ODFOOFFAFFAFAFFFOO
OOFOOOFOOFOOOFOFOO
OOFFFFFFOOOOOOOFDO
OOOOOFOFSFFFFFOOOO
OOFFFFOOFOFOOFFFOO
OOOOOOOODOOOOOOOOO
OOOOOOOOOOOOOOOOOO
