###################
##	MAP N°3      ##
###################
# O = obstacle
# D = door
# E = exit
# F = tile
# T = fire trap
OOOOOOOOOOOOOOOOOO
OOOOOOOOODOOOOOOOO
OOFFFFFFFFFFFFFFOO
OOFFFFFFFFFFFBFFOO
OOFFFFFFFFFFFFFFOO
OOFFFFFFFFFFFFFFOO
ODFFFFFFFFFFFFFFOO
OOFFFFFFFFFFFFFFOO
OOFFFTFFFFFFFFFFOO
OOFFFFFFFFFFFFFFOO
OOFSFFFFFFFFPFFFDO
OOFFFFFFFFFFFFFFOO
OOODOOOOOOOOOOOOOO
OOOOOOOOOOOOOOOOOO
