###################
##	MAP N°4      ##
###################
OOOOOOOOOOOOOOOOOO
OOOOOOOOOOOOODOOOO
OOFFFFFFFFFFFFFFOO
OOFFFFFFFFFFFFFFOO
OOFFFFFFFFFFFFFFOO
OOFFFFFFFFFFFFFFOO
OOFFFFFFFFFFFFFFOO
ODFFFFFFFFFFFFFFOO
OOFFFFFFFFFFFFFFOO
OOFFFFFFFFFFFFFFDO
OOFFFFFFFFFFFFFFOO
OOFFFFFFFFFFFFFFOO
OOOOOOOODOOOOOOOOO
OOOOOOOOOOOOOOOOOO
