##################
##    MAP N°4   ##
##################
OOOOOOOOOOOOOOOOOO
OOOOOOOODOOOOOOOOO
OOTTTTORFLOTTTTTOO
OOTTTTORFLOTTTTTOO
OOOOOOORFLOOOOOOOO
OOZZZZZFFFZZZZZZOO
ODFFFFFFFFFFFFFFDO
OOAAAAAFFFAAAAAAOO
OOOOOOORFLOTTTTTOO
OOTTTTORFLOTTTTTOO
OOTTTTORFLOTTTTTOO
OOTTTTORFLOTTTTTOO
OOOOOOOODOOOOOOOOO
OOOOOOOOOOOOOOOOOO
