##################
##    MAP N°5   ##
##################
OOOOOOOOOOOOOOOOOO
OOOOOOOODOOOOOOOOO
OO1FFFFFFFFFFFF1OO
OOFTFTFTTFTFFTFFOO
OOFTFTFTFFTFFTFFOO
OOFTFTFTFFTFFTFFOO
ODFTTTFTTFTFFTFFDO
OOFTFTFTFFTFFTFFOO
OOFTFTFTFFTFFTFFOO
OOFTFTFTTFTTFTTFOO
OOFFFFFFFFFFFFFFOO
OO1FFFFFFFFFFFF1OO
OOOOOOOODOOOOOOOOO
OOOOOOOOOOOOOOOOOO
