##################
##	MAP N°6     ##
##################
# O = obstacle
# D = door
# E = exit
# F = tile
# T = fire trap
# S = spike trap
# B = bear trap
# P = pit trap
# R, L, A, Z = right left top bottom push trap
OOOOOOOOOOOOOOOOOO
OOOOOOOOODOOOOOOOO
OOOOOOOOOFFFFFFFOO
OOOOOOOOOFFFOOFFOO
OOOOOOOOOFFFOOFFOO
OOOOOOOOOFFFOOFFOO
ODFFFFFFFFFFFFFFDO
OOFOOOOFFFFFFFFFOO
OOFOFFFFFFFFOOOOOO
OOFOOOFFFFFFOFOFOO
OOFOFFFFOFOFOOOOOO
OOFFFFFFFFFFOFOOOO
OOOOOOOODOOOOOOOOO
OOOOOOOOOOOOOOOOOO