##################
##    MAP N°6   ##
##################
OOOOOOOOOOOOOOOOOO
OOOOOOOODOOOOOOOOO
OOFFFFFFFFFFFFFFOO
OOFFFFFFFFFFFFFFOO
OOFFOOOFFOOOOOFFOO
OOFFOFFFFFFFFOFFOO
ODFFOF1FFVF1FOFFDO
OOFFOF1FFFF1FOFFOO
OOFFOFFFFFFFFOFFOO
OOFFOOOOFFOOOOFFOO
OOFFFFFFFFFFFFFFOO
OOFFFFFFFFFFFFFFOO
OOOOOOOODOOOOOOOOO
OOOOOOOOOOOOOOOOOO
