##################
##	MAP N°7     ##
##################
# O = obstacle
# D = door
# E = exit
# F = tile
# T = fire trap
# S = spike trap
# B = bear trap
# P = pit trap
# R, L, A, Z = right left top bottom push trap
OOOOOOOOOOOOOOOOOO
OOOOOOOODOOOOOOOOO
OOTTTTTOFOTTTTTTOO
OOTTTTTOFOTTTTTTOO
OOTTTTTOFOTTTTTTOO
OOOOOOOOFOOOOOOOOO
ODFBFFFFFFBFFFBFDO
OOFFFBFFBFFFBFFFOO
OOOOOOOOBFOOOOOOOO
OOTTTTTOFFOTTTTTOO
OOTTTTTOBFOTTTTTOO
OOTTTTTOFFOTTTTTOO
OOOOOOOODOOOOOOOOO
OOOOOOOOOOOOOOOOOO