##################
##	MAP N°8     ##
##################
# O = obstacle
# D = door
# E = exit
# F = tile
# T = fire trap
# S = spike trap
# B = bear trap
# P = pit trap
# R, L, A, Z = right left top bottom push trap
OOOOOOOOOOOOOOOOOO
OOOOOOOOOOOOODOOOO
OOFFFFFFFFFFFFFFOO
OOFOOOOOOOOOOOOFDO
OOFOOOOOOOOOOOOFOO
OOFOOOOOOOOOOOOFOO
OOFOOOOOOOOOOOOFOO
OOFFFFFFFFFFFFFFOO
ODFOOOOOOOOOOOOOOO
OOFOOOOOOOOOOOOOOO
OOFFFFFOOOOOOOOOOO
OOOOOOFOOOOOOOOOOO
OOOOOODOOOOOOOOOOO
OOOOOOOOOOOOOOOOOO