##################
##	  MAP N°9   ##
##################
# O = obstacle
# D = door
# E = exit
# F = tile
# T = fire trap
# S = spike trap
# B = bear trap
# P = pit trap
# R, L, A, Z = right left top bottom push trap
OOOOOOOOOOOOOOOOOO
OOOOOOOOODOOOOOOOO
OOOOOOOSSFSSOOOOOO
OOOOOOSSFFSSOOOOOO
OOSSSSSSFSSSSSSSOO
OOSSSSSFFSSSSSSSOO
ODFFFFFF1FFFFFFFDO
OOSSSSSSSFFFSSSSOO
OOSSSSSSSSFFSSOOOO
OOOOOOOSSFFSSOOOOO
OOOOOOOSSFSSOOOOOO
OOOOOOOSSFSSOOOOOO
OOOOOOOOODOOOOOOOO
OOOOOOOOOOOOOOOOOO