###################
##    MAP N°2    ##
###################
OOOOOOOOOOOOOOOOOO
OOOOOOOODOOOOOOOOO
OOFFFFFFFFFFFFFFOO
OOFFFFFFFFFFFFFFOO
OOFFFFFFFFFFFFFFOO
OOFFFFFFFFFFFFFFOO
ODFFFFFFFFFFFFFFDO
OOFFFFFFFFFFFFFFOO
OOFFFFFFFFFFFFFFOO
OOFFFFFFFFFEFFFFOO
OOFFFFFFFFFFFFFFOO
OOFFFFFFFFFFFFFFOO
OOOOOOOODOOOOOOOOO
OOOOOOOOOOOOOOOOOO