###################
##    MAP N°3    ##
###################
OOOOOOOOOOOOOOOOOO
OOOOOOOOOOOOODOOOO
OOFFFFFFFFFFFFFFOO
OOFFFFFFFFFFFFFFOO
OOFFFFFFFFFFFFFFOO
OOFFFFFEFFFFFFFFOO
OOFFFFFFFFFFFFFFOO
OOFFFFFFFFFFFFFFOO
OOFFFFFFFFFFFFFFDO
ODFFFFFFFFFFFFFFOO
OOFFFFFFFFFFFFFFOO
OOFFFFFFFFFFFFFFOO
OOOOOOOOOOODOOOOOO
OOOOOOOOOOOOOOOOOO