##################
##	  MAP N°4   ##
##################
OOOOOOOOOOOOOOOOOO
OOOOOOOOOOOOODOOOO
OOFFFFFFFFFFFFFFOO
OOFOOFFOOFFOOOOFDO
OOFOOFFOOFFOOFOOOO
OOFOOFFOOFFOOOOFOO
OOFOOOOOOFFOOFFFOO
OOFOOFFOOFFOOFFFOO
ODFOOFFOOFFOOFFFOO
OOFOOFFOOFFOOFFFOO
OOFFFFFFEFFFFFFFOO
OOFFFFFFFFFFFFFFOO
OOOOOODOOOOOOOOOOO
OOOOOOOOOOOOOOOOOO