##################
##	  MAP N°4   ##
##################
OOOOOOOOOOOOOOOOOO
OOOOOOOOOOOOODOOOO
OOFFFFFFFFFFFFFFDO
OOFFOFFOFFFOOOOFOO
OOFFOFFOFFFOFFOFOO
OOFFOFFOFFFOFFOFOO
OOFFOOOOFFFOOOOFOO
OOFFOFFOFFFOFFFFOO
ODFFOFFOFFFOFFFFOO
OOFFOFFOFFFOFFFFOO
OOFFFFFFEFFFFFFFOO
OOFFFFFFFFFFFFFFOO
OOOOOODOOOOOOOOOOO
OOOOOOOOOOOOOOOOOO