##################
##	  MAP N°5   ##
##################
OOOOOOOOOOOOOOOOOO
OOOOOOOOOOOOODOOOO
OOFFFFFFFFFFFFFFOO
OOFOOFFOOFFOOOOFDO
OOFOOFFOOFFFOOFFFO
OOFOOFFOOFFFOOFFOO
OOFOOOOOOFFFOOFFOO
OOFOOFFOOFFFOOFFOO
ODFOOFFOOOFOOOFFOO
OOFOOFFOOFOOOFFFOO
OOFFFFFFEFFFFFFFOO
OOFFFFFFFFFFFFFFOO
OOOOOODOOOOOOOOOOO
OOOOOOOOOOOOOOOOOO