##################
##	  MAP N°5   ##
##################
OOOOOOOOOOOOOOOOOO
OOOOOOOOOOOOODOOOO
OOFFFFFFFFFFFFFFOO
OOFFOFFOFFFFOOOFDO
OOFFOFFOFFFFFOFFOO
OOFFOFFOFFFFFOFFOO
OOFFOOOOFFFFFOFFOO
OOFFOFFOFFFFFOFFOO
ODFFOFFOFFOFFOFFOO
OOFFOFFOFFOOOOFFOO
OOFFFFFFEFFFFFFFOO
OOFFFFFFFFFFFFFFOO
OOOOOODOOOOOOOOOOO
OOOOOOOOOOOOOOOOOO