###################
##      MAP N°2      ##
###################
OOOOOOOOOOOOOOOOOO
OOOOOOOODOOOOOOOOO
OO              OO
OO              OO
OO              OO
OO              OO
OD      E       DO
OO              OO
OO              OO
OO              OO
OO              OO
OO              OO
OOOOOOOODOOOOOOOOO
OOOOOOOOOOOOOOOOOO
