###################
##      MAP N°3      ##
###################
OOOOOOOOOOOOOOOOOO
OOOOOOOOOOOOODOOOO
OO              OO
OO              OO
OO              OO
OO              OO
OO      E       OO
OO              OO
OO              DO
OD              OO
OO              OO
OO              OO
OOOOOOOOOOODOOOOOO
OOOOOOOOOOOOOOOOOO
